####### #######                                                                 
#.!#.*# #..#..#                                                                 
#..#..# #..#..#                                                                 
##+##+###+##+###################################################################
#....*.....*...................................................................#
##+##+#.#$##+#######################################.................::::......#
#..#..#.#..#..#                                    #.........:::::::::.........#
#..#..#.#..#..#                                 ::::::::::::::::::.............#
#######.#:#####:::::::                    :::::::::::::::::!...................#
     ::=::::: ::::::::::::::::       ::::::::::::::#....::::::::::.............#
  :::::=::::::::    :::::::::::: ::::::::::        #..*........::::::..........#
::::::#.#######      :::   ::::::::                #...............:::.........#
::::..#.#..#..#       :::                          #.................::........#
:..#..#.#..#..#        :::                         #*.................:........#
##+##+#.#+##+###########::##########################.......*...................#
#.......................::.........*...........*...............................#
##+##+###+##+############::##.##################################################
#..#..# #..#..#         ::: #.#                                                 
#..#..# #..#..#       :::   #.#                                                 
####### #######      :      ###                                                 