####### #######                                                                 
#..#.*# #..#..#                                                                 
#..#..# #..#..#                                                                 
##+##+###+##+###################################################################
#....*.....*...................................................................#
##+##+#.#$##+#######################################.................::::......#
#..#..#.#..#..#                                    #.........:::::::::.........#
#..#..#.#..#..#                                 ::::::::::::::::::.............#
#######.#######:::::::                    :::::::::::::::::....................#
     ::=: ::: ::::::::::::::::       ::::::::::::::#....::::::::::.............#
  :::::=::::::::     ::::::::::: ::::::::::        #...........::::::..........#
::::::#.#######            ::::::::                #...............:::.........#
::::..#.#..#..#                                    #.................::........#
:..#..#.#..#..#                                    #..................:........#
##+##+#.#+##+#######################################...........................#
#..............................................................................#
##+##+###+##+###################################################################
#..#..# #..#..#                                                                 
#..#..# #..#..#                                                                 
####### #######                                                                 