################################################################################
#.@.#...#...#...#...#...#...#...#...................................~..........#
#...#...#...#...#...#...#...#...#..................................~~~~........#
#...#...#...#...#...#...#...#...#................................~~~~~~........#
##+###+###+###+###+###+###+###+##...............................~~~~~~~~.......#
#...............................................................~~~~~~~~~~.....#
#......................................:::.......................~~~~~~~~......#
#...................................:::::..........................~~~~~~......#
#.............................:::::::::::::........................~~~~........#
#..............................:::::::::............................~..........#
#.................................:::::::......................................#
#...................................::::::.....................................#
#...............................:::::::::......................................#
#.............................::::::::::::::::::::::...........................#
#.................................==========...................................#
#.............................:::::::::::::::::................................#
#..........................:::::::::::::::::...................................#
#...............................:::::::::::....................................#
#................................:::::::::::::.................................#
###############################::::::::::::::::::::::###########################