####### #######                                                                 
#..#.*# #..#..#                                                                 
#..#..# #..#..#                                                                 
##+##+###+##+###################################################################
#....*.....*...................................................................#
##+##+#.#+##+###################################################################
#..#..#.#..#..#                                                                 
#..#..#.#..#..#                                                                 
#######.#######:::::::                                                          
     ::=: ::: ::::::::::::::::                                                  
  :::::=::::::::     ::::::::::: ::::::::::                                     
::::::#.#######            ::::::::                                             
::::..#.#..#..#                                                                 
:..#..#.#..#..#                                                                 
##+##+#.#+##+###################################################################
#..............................................................................#
##+##+###+##+###################################################################
#..#..# #..#..#                                                                 
#..#..# #..#..#                                                                 
####### #######                                                                 