################################################################################
#.@.#...#...#...#...#...#...#...#..............................................#
#...#...#...#...#...#...#...#...#..............................................#
##+###+###+###+###+###+###+###+##..............................................#
#..............................................................................#
#..............................................................................#
#..............................................................................#
#..............................................................................#
#..............................................................................#
#..............................................................................#
#..............................................................................#
#..............................................................................#
#..............................................................................#
#..............................................................................#
#..............................................................................#
#..............................................................................#
#..............................................................................#
#..............................................................................#
#..............................................................................#
################################################################################