################################################################################
#.@.#...#...#...#...#...#...#...#...................................~..........#
#...#...#...#...#...#...#...#...#..................................~~~~........#
#...#...#...#...#...#...#...#...#................................~~~~~~........#
##+###+###+###+###+###+###+###+##...............................~~~~~~~~.......#
#...............................................................~~~~~~~~~~.....#
#......................................:::.......................~~~~~~~~......#
#...................................:=:::..........................~~~~~~......#
#.............................:::::::=:::::........................~~~~........#
#..............................::::::=::............................~..........#
#.................................:::=:::......................................#
#...................................:=::::.....................................#
#...............................:::::=:::......................................#
#.............................:::::::=::::::::::::::...........................#
#.................................==========...................................#
##+###+###+###+###+###+###+###:::::::::::::::::................................#
#...#...#...#...#...#...#..:::::::::::::::::...................................#
#...#...#...#...#...#...#...#...:::::::::::....................................#
#...#...#...#...#...#...#...#...#:::::::::::::.................................#
###############################::::::::::::::::::::::###########################